#########
#      E#
#  #  # #
# B#T## #
#  ##   #
#S      #
#########